00000000000000000000000000000000000000
31111111111111111110000000000000000000
00000000000000000010000000000000000000
00000000000000000010000000000000000000
00000000000000000010000000000000000000
00000000000000000011111111111111111112
00000000000000000000000000000000000000
|
1