00000000000000000000000000000000000000
32222222222222222220000000000000000000
00000000000000000020000000000000000000
00000000000000000020000000000000000000
00000000000000000020000000000000000000
00000000000000000022222222222222222221
00000000000000000000000000000000000000
|
1
|