00000000000000000000000000000000000000
00000011111000111110001111100011111000
00000010001000100010001000100010001000
00000010001000100010001000100010001000
31111110001000100010001000100010001000
00000000001000100010001000100010001000
00000010001000100010001000100010001000
00000000001111100011111000111110001112
00000000000000000000000000000000000000
|
1