00000000000000000000000000000000000000
00000022222000222220002222200022222000
00000020002000200020002000200020002000
00000020002000200020002000200020002000
32222220002000200020002000200020002000
00000000002000200020002000200020002000
00000000002000200020002000200020002000
00000000002222200022222000222220002221
00000000000000000000000000000000000000
|
1
|